地||地||地||墙||墙||墙||墙||墙||墙||地
地||墙||墙||墙||地||地||地||地||墙||地
墙||墙||洞||地||箱||墙||墙||地||墙||墙
墙||洞||洞||箱||地||箱||地||地||人||墙
墙||洞||洞||地||箱||地||箱||地||墙||墙
墙||墙||墙||墙||墙||墙||地||地||墙||地
地||地||地||地||地||墙||墙||墙||墙||地
