墙||墙||墙||墙||墙||地||地||地||地
墙||地||地||地||墙||墙||地||地||地
墙||地||箱||地||地||墙||地||地||地
墙||墙||地||箱||地||墙||墙||墙||墙
地||墙||墙||墙||人||洞||地||地||墙
地||地||墙||地||地||洞||墙||地||墙
地||地||墙||地||地||地||地||地||墙
地||地||墙||墙||墙||墙||墙||墙||墙